ITEM, TM AND HM LOCATIONS: 
For wild held items, Rare = 10%. 20% with Compound Eyes. Common = 45%. 65% with Compound Eyes. 

Evolution Items (and evolution related)	
Fire Stone	Goldenrod Department Store, bug contest 2nd place, shard vendor at pewter museum
Water Stone	Goldenrod Department Store, bug contest 2nd place, shard vendor at pewter museum, Ruins of Alph Omanyte Chamber rewards room
Thunder Stone	Goldenrod Department Store, bug contest 2nd place, shard vendor at pewter museum
Metal Coat	Mahogany Mart after Goldenrod Rockets defeated, SS Aqua ; Wild: Beldum (Rare), Magnemite (Rare), Magneton (Rare), Magnezone (Rare), Metagross (Rare), Metang (Rare), Steelix (Rare)
Dragon Scale	Mahogany Mart after Goldenrod Rockets defeated, Mt. Mortar ; Wild: Bagon (Rare), Dragonair (Rare), Dragonite (Rare), Dratini (Rare), Horsea (Rare), Kingdra (Rare), Salamence (Rare), Seadra (Rare), Shelgon (Rare)
Up-Grade	Mahogany Mart after Goldenrod Rockets defeated, Saffron City ; Wild: Porygon (Rare), Porygon2 (Rare)
King's Rock	Mahogany Mart after Goldenrod Rockets defeated, Slowpoke well ; Wild: Hariyama (Rare), Politoed (Rare), Poliwhirl (Rare), Slowbro (Rare), Slowking (Rare), Slowpoke (Rare)
Spell Tag	Mahogany Mart after Goldenrod Rockets defeated, Blackthorn City, Mt Silver ; Wild: Banette (Rare), Dusclops (Rare), Dusknoir (Rare), Duskull (Rare), Misdreavus (Rare), Shuppet (Rare)
NeverMeltIce	Mahogany Mart after Goldenrod Rockets defeated, Ice path ; Wild: Glalie (Rare), Snorunt (Rare)
Leaf Stone	1st place in Bug Contest, Pewter City Museum Treasure Hunter for Green Shards
Sun Stone	1st place in Bug Contest, Pewter City Museum Treasure Hunter for Red Shards
Deep Sea Scale	Route 25 Bill's Grandpa,  Pewter City Museum Treasure Hunter for Blue Shards ; Wild: Chinchou (Common), Clamperl (Rare), Lanturn (Common)
Deep Sea Tooth  Route 25 Bill's Grandpa,  Pewter City Museum Treasure Hunter for Yellow Shards ; Wild: Clamperl (Common)
Moon Stone	1st place in Bug Contest, Route 27, Ruins of Alph Aerodactyl Chamber rewards room, buy at Mt. Moon
Heart Scale	Rock Smash ; Wild: Feebas (Common), Feebas (Rare), Magikarp (Rare), Milotic (Common), Milotic (Rare)
Blue Shard	Rock Smash; Wild: Tentacool (Rare), Tentacruel (Rare)
Yellow Shard	Rock Smash; Wild: Chinchou (Rare), Lanturn (Rare)
Red Shard	Rock Smash; Wild: Carvanha (Rare), Sharpedo (Rare)
Green Shard	Rock Smash; Wild: Relicanth (Rare), Wailmer (Rare)
		
Hold items		
Amulet Coin	Goldenrod Underground
Choice Band	Battle Tower, Saffron City Dojo VIP Lounge
Black Belt	Lake of Rage
BlackGlasses	Dark Cave ; Wild: Mightyena (Rare)
Brightpowder	Goldenrod Radio Tower
Charcoal	Azalea Town ; Wild: Torkoal (Rare)
Cleanse Tag	Route 5 ; Wild: Chingling (Rare)
Dragon Fang	Dragons Den
Everstone	Show togepi to elm ; Wild: Geodude (Rare), Graveler (Rare)
EXP. Share	Violet city, goldenrod, mr pokemons house
Focus Band	Battle Tower, Saffron City Dojo VIP Lounge
Hard Stone	Route 36 ; Wild: Aron (Rare), Lairon (Rare)
Leftovers	Battle Tower, Saffron City Dojo VIP Lounge, Celadon ; Wild: Munchlax (Common), Munchlax (Rare), Snorlax (Common), Snorlax (Rare)
Light Ball	Wild Pikachu (Rare), Pikachu (Common) 
Lucky Egg	Wild: Blissey (Rare), Chansey (Rare), Happiny (Common)
Lucky Punch	Route 47 ; Wild: Chansey (Common)
Magnet		Route 37 ; Wild: Electabuzz (Rare), Elekid (Rare), Probopass (Rare)
Metal Powder	Wild: Ditto (Rare)
Miracle Seed	Route 32 ; Wild: Breloom (Rare), Shroomish (Rare)
Mystic Water	Cherry grove ; Wild: Castform (Common), Castform (Rare)
NeverMeltIce	Mahogany shop
Silk Scarf	Route 29 ; Wild: Happiny (Rare)
Poison Barb	Route 32 ; Wild: Budew (Rare), Cacnea (Rare), Cacturne (Rare), Roselia (Rare)
Quick Claw	National park ; Wild: Sandshrew (Rare), Sandslash (Rare), Sneasel (Rare), Weavile (Rare)
Scope Lens	Battle Tower, Saffron City Dojo VIP Lounge
Sharp Beak	Route 40 ; Wild: Doduo (Rare), Fearow (Rare)
Silverpowder	Wild: Butterfree (Rare)
Smoke Ball	Goldenrod underground ; Wild: Koffing (Rare), Weezing (Rare)
Soft Sand	Route 34 ; Wild: Trapinch (Rare)
Spell Tag	Blackthorn city
Stick		Wild: Farfetch'd (Rare)
Thick Club	Wild: Cubone (Rare), Marowak (Rare)
TwistedSpoon	Wild: Abra (Rare), Kadabra (Rare)
Lax Incense	Route 38
Sea Incense	Safari zone gate
Macho Brace	Machop trade goldenrod
Mental Herb	Battle Tower, Saffron City Dojo VIP Lounge
Shell Bell	Route 20
Soothe Bell	National park
White Herb	Battle Tower, Saffron City Dojo VIP Lounge
Black Flute	Dark cave
White Flute	Route 47
Fairy Gem	Wild: Azurill (Rare)
Sacred Ash	Ruins of Alph Ho-oh Chamber; Wild: Ho Oh (Common), Ho Oh (Rare)

Misc Items
Moomoo Milk	Route 39 Farm after healing Miltank. Wild: Miltank (Common), Miltank (Rare)	
Nugget		Wild: Grimer (Rare), Muk (Rare)	
Big Mushroom	Wild: Paras (Rare)
Pearl		Wild: Cloyster (Common), Shellder (Common)
Big Pearl	Wild: Cloyster (Rare), Shellder (Rare)
Stardust	Wild: Starmie (Common), Staryu (Common)
Star Piece	Wild: Starmie (Rare), Staryu (Rare)
Tiny Mushroom	Wild: Paras (Common)
Vitamins 	Department stores, Battle Tower, Saffron City Dojo VIP Lounge

Berries
Oran Berry	Route 29, Route 30; Wild: Furret (Common), Linoone (Common), Pichu (Rare), Sentret (Rare), Shuckle (Common), Shuckle (Rare), Zigzagoon (Rare)	
Cheri Berry	Route 31, Violet City
Pecha Berry	Route 33, Azalea Town; Wild: Mightyena (Common), Poochyena (Rare)	
Persim Berry	Route 35, Route 36; Wild: Farigiraf (Rare), Girafarig (Rare), Kecleon (Rare)
Chesto Berry	Route 37, Route 42; Wild: Loudred (Rare), Whismur (Rare)
Rawst Berry	Route 38, Route 39; Wild: Growlithe (Common), Growlithe (Rare), Magby (Common), Magby (Rare), Magmar (Common), Magmar (Rare), Numel (Common), Numel (Rare), Vulpix (Common), Vulpix (Rare)
Leppa Berry	Route 43; Wild: Skitty (Rare)
Aspear Berry	Route 44, Route 45; Wild: Smoochum (Common), Smoochum (Rare)
Lum Berry	Route 46; Wild: Celebi (Common), Celebi (Rare), Mew (Common), Mew (Rare)
Sitrus Berry	Route 47; Wild: Furret (Rare), Linoone (Rare)	
Pomeg Berry	Route 3, Pewter City
Kelpsy Berry	Route 24, Route 25
Qualot Berry	Route 13, Fuchsia City
Hondew Berry	Route 16, Celadon City
Grepa Berry	Route 6, Route 11
Tomato Berry	Route 4, Route 7
	
Key items
Bike			 Goldenrod Bike Shop
Radio			 Goldenrod Radio Tower		
Basement Key		 Radio Tower (False Manager)
Card Key		 Goldenrod Underground (Manager)
Tidal or Clear Bell	 Goldenrod Radio Tower (Manager)
GS Ball			 Ruins of Alph (resets on league clears)
Lost Item		 Vermillion City
Machine Part		 Cerulean City
Mystery Egg		 Route 30
Old Rod			 Route 32 (Man inside Pokemon Center)
Pass			 Saffron City (Copycat Girl)
Rainbow Wing		 Ecruteak City (Wise Trio - All three Beasts caught)
Red Scale		 Lake of Rage (Attached to Red Gyarados)
S.S. Ticket		 New Bark Town (Prof. Elm)
SecretPotion		 Cianwood City
Silver Wing		 Pewter City (Old Man)
Old Sea Map		 Vermilion port truck
Eon Ticket		 Fuchsia City Safari Zone Steven 
Mystic Ticket		 Olivine City Girl 

TM's
TM01	Focus Punch	Chuck
TM02	Dragon Claw	Clair
TM03	Water Pulse	Misty
TM04	Calm Mind	Director underground goldenrod
TM05	Roar		Route32
TM06	Toxic		Janine
TM07	Hail		Beat Pryce
TM08	Bulk Up		Blue
TM09	Bullet Seed	Bugsy
TM10	Hidden Power	Lake of rage
TM11	Sunny Day	ilex forest
TM12	Taunt		Burned tower b1f
TM13	Ice Beam	Goldenrod Game Corner 
TM14	Blizzard	Celadon Department Store + ICE PATH
TM15	Hyper Beam	Celadon Department Store
TM16	Light Screen	Goldenrod Department Store
TM17	Protect		Goldenrod Department Store
TM18	Rain Dance	Slowpoke Well
TM19	Giga Drain	Erika
TM20	Safeguard	Goldenrod Department Store
TM21	Frustration	Goldenrod Department Store
TM22	Solarbeam	Route27
TM23	Iron Tail	Jasmine
TM24	Thunderbolt	Goldenrod Game Corner + surge
TM25	Thunder		Celadon Department Store + Power Plant
TM26	Earthquake	Brock
TM27	Return		Goldenrod Department Store
TM28	Dig		National Park
TM29	Psychic		Goldenrod Game Corner, psychic house
TM30	Shadow Ball	Beat Morty
TM31	Brick Break	Route 39
TM32	Double Team	Falkner
TM33	Reflect		Goldenrod Department Store
TM34	Shock Wave	Olivine City Lighthouse
TM35	Flamethrower	Goldenrod Game Corner
TM36	Sludge Bomb	Route 43 guard
TM37	Sandstorm	Route27 house, friendship mon
TM38	Fire Blast	Celadon Department Store
TM39	Rock Tomb	Route 35 floor
TM40	Aerial Ace	Route 14
TM41	Torment		Route 31 Kenya sleeping guy
TM42	Facade		Rock Tunnel
TM43	Secret Power	Union Cave
TM44	Rest		Celadon mansion rooftop house night
TM45	Attract		Whitney
TM46	Thief		Rocket Hideout
TM47	Steel Wing	Route 28
TM48	Skill Swap	Radio tower
TM49	Snatch		Route39 Farm
TM50	Overheat	Blaine
		
HM's
HM01	Cut		Ilex Forest
HM02	Fly		Chuck
HM03	Surf		Ecruteak Theater
HM04	Strength	Olivine Cafe
HM05	Flash		Sprout Tower
HM06	Rock Smash	Route36
HM07	Waterfall	Ice Path
HM08 	Whirlpool	Rocket Hideout